````````````````````````````````````````````````````````````````````````````````````````````````````````````````````````
```pSz``````````````````````````````````````````````````````````````````````````````````````````````````````````````````/
```````````````````````````````````````````cc``````````````````````````````````````cc```````````````````````````````````
````````cc`````````````cc`````````````````c``c````````````````cc``````````````````c``c`````````````````cc```-```````````
```````c```g`af````fg````c```````````````ga``f```````````````c``c```````g``fa``````fg`````````````````c```hfg```````````
`f``g`h```122223``122222```ag`````fg```122222223```fg````f+`h`````fg```12222223``122223```f`````f`a`g````1222223````````
22222223``455A56``45A55B222223``12223``4555A5556``1223``122223``12223``4555A556``45A556``1223``12222223``45A5556````````
5555A556``4A5556``4555555A5556``45A56``455555A56``45A6``455556``45A56``45A55556``4555A6``45A6``4555A556``45555A6````````
55A55556``455556``455A55555A56``45556``45A555556``4556``455556``45556``45555556``455556``4556``4A555556``455A556````````