`````````````````````````````````````````````````````````````````````````````````````````````````````````````````
```p`````````````````````````````````````````````````````````````````````````````````````````````````````````````/
`````````````````````cc```````````````````````````````cc`````````````````````````````````````````````````````````
`````````````cc`````c``c````````````````cc```````````c``c```````````````cc``````````````cc```````````-```````````
````````````c```Q`fg`````gfQ```````````c``c`````````f````h``+g`f````Qfg```c````````````c```fg````g``fg```````````
`f``g`````h`g``122223``122223``````fg```````gQ````1223``122222223``12223``````````fgQ`````1223``1222222223```````
2222223``122222C55A56``455A56``122222223``122223``45A6``45555A556``455A6``1223``12222223``45A6``4555A55556```````
5555A56``45555A555556``45A556``45555A556``455A56``4556``45A555556``4A556``45A6``4555A556``4556``455555A556```````
55A5556``4A55555555A6``455556``45A555556``455556``4556``455555556``45556``4556``45A55556``4556``45A5555556```````