``````````````````````````````````````````````````````````````````````````````````````````````````````````````````````````````````````````
```p``````````````````````````````````````````````````````````````````````````````````````````````````````````````````````````````````````/
`````````````````````````````````cc``````````````````````````````````````````````````````cc`````````````````````````cc````````````````````
```````````````cc```````````````c``c````````````````````cc`````````````cc```````````````c``c`````````````````````fl```c`````-`````````````
``````````````c`````lf```````````fg``````````````````fgl``c```````````c```h`+`fg`````````fg``l```````````fg````12223````h``f``g```````````
`f``gh`````lfg```122223``o``o``122223``1223``o``o``122223````f``l``g`g```12222223``o``122222223``o``o``122223``45A56``1222222223``````````
2222223``122223``455A56````````45A556``45A6````````45A556``122222222223``455A5556`````4555A5556````````455A56``45556``4555555556``````````
5555A56``45A556``455556````````4555A6``4556````````455556``45555A555556``45555A56`````4555555A6````````4A5556``45556``4555555556``````````
55A5556``455556``455556````````455556``4556````````455556``45A555555A56``45555556`````4A5555556````````455556``45556``4555555556``````````