```````````````````````````````````````````````````````````````````````````````````````````````````````````````````````````````
``Sp````````````````````````z``````````````````````````````````````````````````````````````````````````````````````````````````/
```````````````````````````````````````````````````````````````````````````cc``````````````````````````````````````````````````
``````````````````cc`````````````cc```````````````````cc`````````````````````c`````````cc```````````````````cc````-````````````
`````````````````c``c`````````g````c`````````````````c``c`````fgh``````+`gf```````````c``c`````````````````c```hg``f```````````
`f``gh``````````G``fg`G```1222223````f``G````````````fg`G```122223``12222223````g``````fg`G``````````g`f``G```12222223`````````
2222223``o``o``122222223``455A556``1222223``o``o``12222223``455A56``45555A56``1223``12222223``o``o``12222223``455A5556`````````
5555A56````````45555A556``45555A6``455A556````````45555A56``45A556``4A555556``45A6``45555A56````````4555A556``455555A6`````````
55A5556````````45A555556``4555556``45555A6````````45A55556``455556``45555556``4556``4A555556````````45A55556``45555556`````````