````````````````````````````````````````````````````````````````````````````````````````````````````````````````````````````````````````````````````````````````````````
```p````````````````````````````````````````````````````````````````````````````````````````````````````````````````````````````````````````z```````````/```````````````
`````````````````````````````````````````````````````````````````````````cc````````````````````````````````````cc````````````````````````````````-``````````````````````
`````````````````cc`````````````````````````````cc``````````````````````c``c``````````````````````````````````c`````fg`G`hg```````````````G`f```fg``````````````````````
````````````````c``````f``Gf```````fg```````f`G`g`c``````````````````````f`G`g``````````````f+`g````````f``fG````12222222223``f```````P``12222222222223`````````````````
`f``g```````gh``G``12222222223``1222223``122222223``f``````g``````P``12222222223`hg```P``122222223`P``122222223``455555A555B22223``P`````45555A55555556`````````````````
2222223``1222222222C55555A5556``455A556``45555A55B2223``12223``P`````45555A5555B2223`````45555A556````455555A56``45A555555555A556````````45A55555555A56`````````````````
5555A56``4555555A5555555555556``45555A6``45A55555A5556``45A56````````45555555555A556`````45A555556````4A5555556``4555555555555556````````455A5555555556`````````````````
55A5556``4555555555555555555A6``4555556``4555555555556``45556````````45A555555555556`````455555556````455555556``4555555555555556````````45555555555556`````````````````