````````````````````````````````````````````````````````````````````````````````````````````````````````````````````````````````
```p```````````````````````````````````````z````````````````````````````````````````````````````````````````````````````````````/
`````````````````````````````````````````````````````````````cc`````````````````````````````````````````````````````````````````
```````````````cc```````````cc````````````````````cc````````c``c``````````````````cc`````````````cc``````````````cc`````````````
``````````````c``c`````fg`````c``````````````````c````fG````fg```````````````f``gG``c```````````c``c`````````fg`G``c`````-``````
`f``g```h`````g`Gf````1222223``Gg````g``````g``fg```12223``122223````+fgh```12222223``fg`````fg``````g```122222223```fh`g```````
2222222223``12222223``455A55B22223``1223``12222223``45A56``45A556``1222223``45A5555B222223``12223``1223``4555A5556``1222222223``
5555A55556``4555A556``45A55555A556``45A6``45555A56``45556``4555A6``4555A56``45555555555A56``45A56``45A6``455555A56``45555A5556``
55A55555A6``455555A6``455555555556``4556``45A55556``45556``455556``4555556``45555A55555556``45556``4556``45A555556``45A5555556``