`````````````````````````````````````````````````````````````````````````````````````````````````````````````````
```pS````````````````````````````````````````````````````````````````````````````````````````````````````````````/
``````````````````````````````````````````````````````````````````````````````````````cc`````````````````````````
``````````````````cc``````````````````cc```````cc````````````cc``````````````cc``````c``c````````````````````````
`````````````````c````fga`````fg`````c``c`````c``fg`````f+`h```c````````````c````afg``````hg```````-`````````````
`f``g`h``````ga`f```1222223``1223````fga`````f``1223``1222223`````fag`````f````1222223``12223````fg```f``````````
22222223``12222223``455A556``45A6``1222223``1222C5A6``455A556``12222223``1223``455A556``45A56``122222223`````````
5555A556``45A55556``45555A6``4A56``455A556``4555A556``4A55556``4555A556``45A6``45555A6``455A6``45555A556`````````
55A55556``45555A56``4555556``4556``4555556``45555556``45555A6``4A555556``4556``4555556``45556``4A5555556`````````