``````````````````````````````````````````````````````````````````````````````````````````````````````````````````````````
```p```````z``````````````````````````````````````````````````````````````````````````````````````````````````````````````/
``````````````````````````````````````````````````````````````````````cc````````````````````````````cc````````````````````
````````````````cc```````````````cc```````````````````cc`````````````c``c``````cc``````````````````c``c````````-``````````
```````````````c```g`fg`````````c````f`````f`gQ``````c``c`````````+`f``````g`Q```c````````````````g`fg`````h`fg```````````
`f``gh``````fg````122223````Qf`````1223``1222223````f````fg`h```122223``1222223```fg`Q``````f````1222223``122222223```````
2222223``1222223``45A556``1222223``45A6``45A5556``1223``122223``455A56``4555A56``1222223``12223``4555A56``455A55556```````
5555A56``455A556``4555A6``455A556``4556``4555A56``4A56``45A556``4A5556``4A55556``455A556``45A56``4A55556``455555A56```````
55A5556``45555A6``455556``4555556``4556``4555556``4556``4555A6``455556``4555556``45555A6``45556``4555556``455555556```````