```````````````
```p/``````````
````z``````````
```````````````
``````q````f```
3`f``g``1222222
B2222222C5A5555
55555A555555A55
555A55555555555