``````````````````````````````````````````````````````````````````````````````````````````````````````````````````````
```pz`````````````````````````````````````````````````````````````````````````````````````````````````````````````````/
``````````````````````````````cc`````````````````````````````````````````cc```````````````````````````````````````````
````````````````cc```````````c``c```````````````cc``````````````````````c``c`````cc``````````````cc```````````````````
```````````````c````fg`Q``````fg``g````````````c``c`````````gQ````h`f+`g`````fQ````c`````````fgh```c```````-``````````
`f``gh`````fg`Q```1222223``122222223````f````f`fgQ`````f``12223``12222223``122223```Q`fg````12223````gQ```f```````````
2222223``1222223``4555A56``45555A556``1223``12222223``1222C5A56``455A5556``455A56``1222223``45A56``12222222223````````
5555A56``45A5556``4A55556``455A55556``45A6``4555A556``45A555556``455555A6``455556``4555A56``45556``455555A5556````````
55A5556``45555A6``4555556``455555556``4556``4A555556``455555A56``45555556``455556``4A55556``45556``45A55555A56````````