`````````````````````````````````````````````````````````````````````````````````````````````````````````````````````````````````````````````````
```p````````````````````````````````````````````````````````````````````````````````````````````````````````````````````````````````````````/````
````````````````cc`````````````````````````````````````````````cc````````````````````````````````````````````````````````````````````````````````
```````cc``````c``c```````````````cc```````````cc`````````````c``c````````````````cc`````````````````````````cc````````````cc`````-``````````````
``````c```h`gfl`````gl``````````g```c`````````c``c`````````fgl`````g```````hf+`gf```c```````````````````````c``c``````````c`````fg`f`````````````
`f``g````1222223``12223``o``o``1223`lgf`````````gf````f``122223``1223``o``122222223````lg`````fgl````````````fg````````gfl```122222223```````````
2222223``455A556``45A56````````4A5B22223``o``122223``1222C5A556``45A6`````455A55556``12223``1222223``o``o``122223``o``12223``455A55556```````````
5555A56``45555A6``45556````````45555A556`````455A56``455A5555A6``4556`````4555555A6``45A56``455A556````````455A56`````45A56``4555555A6```````````
55A5556``4555556``45556````````455A55556`````455556``4555555556``4556`````455555556``45556``45555A6````````455556`````45556``455555556```````````