````````````````````````````````````````````````````````````````````````````````````````````````````````````````````````````````````````````
```p`S``````````````````````````````````````````````````````````````````````````````````````````````````````````````````````````````````````/
`````````````````````````````````````````````````````````````````````````````````````````````cc`````````````````````````````````````````````
````````````````````````````````cc````````````````````````cc`````````````````cc`````````````c``c````````````cc```````````-``````````````````
`````````````````gG````````````c``c``````````````````f`g````c```````````````c````f````````````fg`G`````````c``c`````h`fg````````````````````
`f``gh`````````12223``P`````````fg`G`````````````P``1222223`f``G`````h`+``fg```1223``P``P``12222223````````fg``````122222222223`````````````
2222223``P``P``45A56``````P``12222223``12223``P`````455A55B2222223``122222223``45A6````````4555A556``P``122222223``455555A55556`````````````
5555A56````````45556`````````455A5556``45A56````````45555555A55556``4555A5556``4A56````````45555556`````45555A556``45A5555555A6`````````````
55A5556````````45556`````````45555A56``45556````````45A555555555A6``45A555556``4556````````455A5556`````455A55556``455555555556`````````````