`````````````````````````````````````````````````````````````````````````````````````````````````````````````````````````
```pz````````````````````````````````````````````````````````````````````````````````````````````````````````````````````/
`````````````````````cc``````````````````````````````````````````````````````````````cc``````````````````````````````````
`````````cc`````````c``c`````````cc````````cc``````````cc```````````````cc``````````c``c`````````cc```````````-``````````
````````c````fgQ`````f`f````````c``c``````c```g`````fQ```c`````````````c```f`g`Q````fg`f````````c````f`````hfg```````````
`f``g`h````122223``122223````gfQ`````f``g```12223``1223```hf`+`f````Qg````1222223``122223````fg`Q```1223``1222223````````
222222223``45A556``4555A6``122223``122222222C5A56``45A6``12222223``12223``45A5556``455A56``1222223``45A6``4555556````````
55555A556``4555A6``45A556``455A56``455A5555555556``4556``455A5556``45A56``4555A56``45A556``455A556``4556``4555556````````
55A555556``455556``455556``455556``45555A55A55556``4556``455555A6``45556``4555556``455556``4555556``4556``4555556````````