```````````````````````````````````````````````````````````````````````````````````````````````````````````
```pS```````z``````````````````````````````````````````````````````````````````````````````````````````````/
```````````````````````````````````````````````````````````````````````````````````````````````````````````
````````cc`````````````cc`````````cc`````````````cc``````````````cc`````````````cc````````````-````````````
```````c``c```````````c````g`af`g```c```````````c```g+``````````c```fg`````````c``c```````ahf`g````````````
`f``g`h`````fg``````fg```122222223```f`````g`af````1223````h``fg```1223```g`a`f````gf```122222223``````````
22222223``1222223``1223``45555A556``1223``1222223``45A6``12222223``45A6``1222223``1223``45555A556``````````
5555A556``455A556``45A6``45A555556``4A56``4555556``4556``45555A56``4556``4555556``45A6``455A55556``````````
55A55556``45555A6``4556``455555A56``4556``4555556``4556``45A55556``4556``4555556``4556``45555A556``````````