`````````````````````````````````````````````````````````````````````````````````````````````````````````````````````````
```p````````````````z````````````````````````````````````````````````````````````````````````````````````````````````````/
`````````````````````````````cc```````````````````````````cc``````````````cc``````````````cc``````cc`````````````````````
````````````cc``````````````c``c``````````cc````````lgf`````c````````````c``c``````````g````c````c``c````````-```````````
```````````c``c``````g```````gf``````````c````fg```12222223```fl````h`+`g`````l`fg```122223````gf````fl````h``f``````````
`f``gh`````fg`lg```12223``12222223````f`l```12223``455A555B222223``1222223``1222223``455A56``12223``1223``12222223```````
2222223``12222223``45A56``4555A556``122223``45A56``4555555555A556``4555A56``455A556``455556``45A56``45A6``455A5556```````
5555A56``4555A556``45556``45A55556``45A556``45556``45555A55555556``45A5556``4555A56``455A56``455A6``4556``455555A6```````
55A5556``4A555556``45556``45555556``455556``45556``45555555555556``4555556``4555556``455556``45556``4556``45555556```````