``````````````````````````````````````````````````````````````````````````````````````````````````````````````````````````````````````````````````````````````
```pz````````````````````````````````````````````````````````````````````````cc````````````````````````cc`````````````````````````````````````````````/```````
`````````````cc```````````cc``````````````````cc``````````````````cc````````c``c``````````````````````c``c````````cc```````````````````cc`````-```````````````
````````````c```fG`g`````c``c````````````````c````Gg`f```````````c``c````````g``f```````````````````f`g``G```````c``c`````````````````c``````f```g````````````
``````````g`h`1222223`````fGg````````````g``f```12222223`````````g`f`````G`1222223````hf``+`g``````122222223``````g`Gf`````````G``h``````12222222223``````````
`f``g````12222C55A556``12222223``P``P``1222223``455A5556``P``P``122223``122C55A556``1222222223``P``4555A5556``12222222223``P``122222223``4555A555556``````````
2222223``4555A5555556``45555A56````````4555A56``45555A56````````45A556``45A5555556``45555A5556`````4555555A6``45555A55556`````45555A556``45555555A56``````````
5555A56``45A555555A56``45A55556````````45A5556``45555556````````455556``45555555A6``455A555556`````455555556``45A555555A6`````4A5555556``45555555556``````````
55A5556``455555555556``45555556````````4555556``45555556````````455556``4555555556``4555555556`````455555556``45555555556`````455555556``45555555556``````````