````````````````````````````````````````````````````````````````````````````````````````````````````````````````````````````````````````
```p````````````````````````````````````````````````````````````````````````````````````````````````````````````````````````/```````````
````````````````````````````````````````````````````````cc```````````````````cc`````````````````````cc``````````````````````````````````
```````cc```````````````````````````cc`````````````````c``c`````````````````c``c``````g``fg`````g`f```c``````````````-``````````````````
``````c``c```````````g```f``````f`````c```````````````g``f`````h`g`+``f```````gf````12222223`s`12223`````f``g`````h`f``g````````````````
`f``g``````hf`g``s`12222223`s`12222223``g`````fg```s`1222223``1222222223`s`1222223``4555A556```45A56``12222223`s`122222223``````````````
2222223``1222223```455A5556```45A5555B2223``122223```45A5556``45A5555A56```455A556``4A555556```45556``455A55A6```455555556``````````````
5555A56``4555A56```455555A6```4555555A5556``455A56```4555556``455555A556```4555556``45555556```45556``45555556```455555556``````````````
55A5556``4555556```45555556```4555555555A6``455556```4555556``4555555556```4555556``45555556```45556``45555556```455555556``````````````