````````````````````````````````````````````````````````````````````````````````````````````````````````````````````````
```pS``````````````z````````````````````````````````````````````````````````````````````````````````````````````````````/
``````````````cc```````````````````````````````````````````````````cc```````````````````````````````````````````````````
`````````````c``c```````````````cc``````````cc`````````````cc`````c``````fg`f````````````````cc``````````-``````````````
``````````Ggf`````g``f`````````c```fg``````c``c```````````c`````fG````12222223```f`Gg```````c``c`````hfg```g````````````
`f``gh```12223``12222223```fgG````12223````gf`fG````f`+`hg```1222223``4555A556``1222223`````fg``f```1222222223``````````
2222223``45A56``4555A556``122223``45A56``12222223``12222223``455A556``45A55556``4555A56``122222223``455555A556``````````
5555A56``45556``45A55556``455A56``45556``45555A56``4555A556``45555A6``45555556``45A5556``45555A556``45A5555556``````````
55A5556``45556``455555A6``45A556``45556``45A55556``45555556``4555556``455555A6``4555556``45A555556``455555A556``````````