````````````````````````````````````````````````````````````````````````````````````````````````````````````````````````````````````````
```pS```````````````````````````````````````````````````````````````````````````````````````````````````````````````````````````````````/
```````````````````````````cc```````````````````````````````````````````````````````````````````````````````````````````````````````````
````````cc````````````````c``c`````````````````cc``````````````````````````````cc```````````````cc````````````cc````````````````````````
```````c```f`ag```````````fga`g```````````````c``c```````````````````````g`+fh```c`````````````c``c````g`a`f````c````````-``````````````
`f``g`h```122223``o``o``12222223````f`````````g`a`f`````fg```123``o``o``1222223`````ag`f````````fg````12222223````f````hfg``````````````
22222223``455A56````````45A55556``12223``o``12222223``12223``4A6````````45A5556``12222223``o``122223``4555A556``1223``1222223```````````
5555A556``4A5556````````455A55A6``45556`````4555A556``455A6``456````````4555A56``45555A56`````45A556``45A55556``45A6``455A556```````````
55A55556``455556````````45555556``45556`````45A55556``45556``456````````4555556``45A55556`````455556``45555556``4556``45A5556```````````