```````````````````````````````````````````````````````````````````````````````````````````````````````````````````
``Sp`````````````````````````````````````````````````````````````````````````````````````````````z`````````````````/
````````````````````````````cc`````````````````````````````````````````````````````````````````````````````````````
````````````cc`````````````c``c```````````cc```````````cc```````cc``````cc`````````cc``````````````````-```````````
```````````c``c`````fg`````fg`l``````````c``c`````````c`````fg````c````c```fg`````c``c````````````fg````f``````````
`f``gh``````fg`l```1223``1222223```g``````fg`l````h`+g```1222223````fgl```1223````fgl``````fh```12222222223````````
2222223``12222223``45A6``4555A56``1223``1222223``122223``4555A56``122223``45A6``12222223``1223``455A5555A56````````
5555A56``45555A56``4556``45A5556``4A56``45A5556``45A556``45A5556``455A56``4556``455A5556``45A6``455555A5556````````
55A5556``455A5556``4556``4555556``4556``45555A6``455556``4555556``455556``4556``45555A56``4556``4A555555556````````