`````````````````````````````````````````````````````````````````````````````````````````````````````````````````````````````````
```pz`````````````````````````````````````````````````````````````````````````````````````````````````````````````````````/``````
`````````````````````cc``````````````````````````````````````````````````````````````````````````````````````````````````````````
````````cc``````````c``c```````````````````````cc``````cc``````````````````````cc`````````````````cc```````````cc````-```````````
```````c`````fg````l`fg``l````````````````````c``c````c```lfg```````````hf+`g````c```````````````c``c`````````c```hg``f``````````
`f``g`h```122223``122222223`````fgl```````````f`g````f``1222223``o``o``12222223````fg`l````````````fg``````lf````12222223````````
22222223``455A56``45555A556``1222223``o``o``122223``1222C55A556````````4555A556``1222223``o``o``1222223``122223``4555A556````````
5555A556``4A5556``45A555556``455A556````````455A56``455A5555556````````45A55556``455A556````````455A556``455A56``4A555556````````
55A55556``455556``4555555A6``4555556````````455556``455555555A6````````45555556``4555556````````4555556``4555A6``45555556````````