`````````````````````````````````````````````````````````````````````````````````````````````````````````````````````
```p```````z````````````````````````````````````````````````````````````````````````````````````````````````````````/
```````````````````````````````````````````````````````````````````````cc````````````````````````````````````````````
`````````````````cc`````````````cc``````````````````cc`````````cc`````c``c``````cc``````````````cc`````-`````````````
````````````````c``c```````````c``c`````f`g`````fg````c```````c```g`+``````fg`````c````````````c````fg``f````````````
`f``gh``````fg````````gf````````fg````122223`s`12223```g``````fh`122223``1222223````fg```````hg```122222223``````````
2222223``12222223``1222223`s`1222223``45A556```45A56``1223`s`1222C5A556``455A556``1222223`s`1223``455555556``````````
5555A56``4555A556``455A556```455A556``4555A6```45556``4A56```455A5555A6``4555556``4555556```45A6``455555556``````````
55A5556``455555A6``4555556```45555A6``455556```45556``4556```4555555556``4555556``4555556```4556``455555556``````````