```````````````````````````````````````````````````````````````````````````````````````````````````````
``Sp``````````````z````````````````````````````````````````````````````````````````````````````````````/
````````````````````````cc`````````````````````````````````````````````````````````````````````````````
``````````````cc```````c``c`````cc````````````````````````cc`````````cc````````````````````-```````````
`````````````c```````g``````fgl```c```````g`f`l``````````c```fl`````c``c``````````gf````lf`````````````
`f``gh````lfg```12222223``122223````f````1222223```h`+`gf```1223```g``````fg`````1223``12222223````````
2222223``12223``45555A56``455A56``12223``4555A56``12222223``45A6``123``12222223``45A6``455555A6````````
5555A56``455A6``455A5556``4A5556``45A56``455A556``45A55556``4556``4A6``45555A56``4A56``455A5556````````
55A5556``45A56``45555556``455556``455A6``4555556``45555A56``4556``456``455A5556``4556``45555556````````