```````````````
``Sp/``````````
````z``````````
```````Q```````
```````````````
``f``g``````fg`
222222222222222
55555A555555A55
555A55555555555