````````````````````````````````````````````````````````````````````````````````````````````````````````````
```pS```````````````````````````````````````````````````````````````````````````````````````````````````````/
`````````````````````````cc`````````````````````````````````cc``````````````````````````````````````````````
````````````cc`````````````c``````cc`````````cc````````````c``c````````````````cc``````````````-````````````
```````````c``c``````Gf``````````c``c```````c``fg````f`+g`h````f``G```````````c``c```````````fg`````````````
`f``gh``````fg`````122223```G`fg`````ff````g``1223``12222223``122223```fg`````fgG`````f```122222223`````````
2222223``12222223``455A56``1222223``1223``1222C5A6``4555A556``45A556``12223``122223``123``455A55556`````````
5555A56``455A5556``455556``4555A56``45A6``4A555556``4A555556``455556``45A56``45A556``4A6``4555555A6`````````
55A5556``455555A6``455556``4A55556``4556``45555556``45555556``4555A6``45556``455556``456``455555556`````````