``````````````````````````````````````````````````````````````````````````````````````
``Spz`````````````````````````````````````````````````````````````````````````````````/
`````````````b``````````b``````````b```````b```````````````b````````b```````b`````````
```a`````````cc```````````````cc```````````````cc`````````````````````````````````````
````````````c``c`````````f`g````c`````````````c```gf`````f```````````````-````````````
`f``g````````fg```g```12222223````f`````fg``f````1223``122222223`````fg`````gf````````
2222223``12222222223``45555A56``1223``122222223``45A6``45555A556``12222222222223``````
5555A56``4555555A556``455A5556``45A6``45555A556``4A56``45A555556``45555555A55556``````
55A5556``455A55555A6``45555556``4556``455A55556``4556``455555556``4555A555555A56``````