`````````````````````````````````````````````````````````````````````````````````````````````````````````````````````````````
```p`````````````````````````````````````````````````````````````````````````````````````````````````````````````````````````/
````````````````````````````````````````````cc`````````````cc```````````````cc```````````````````````````````````````````````
``````````````````cc```````````````````````c``c```````````c```f````````````c```g````````````````````````cc```````````-```````
`````````````````c``c```````````````````````fg`````````Qf````1223``````hf+g```1223````fgQ``````````````c``c`````````fg```````
`f``gh```````````fg`f````gQ```1223``o``o``122223``o``122223``45A6``o``122223``45A6``12222223```````fQ`g````h`g````1222223````
2222223``o``o``1222223``1223``45A6````````455A56`````455A56``4556`````455A56``4556``45555A56``o``1222223``122223``4555A56````
5555A56````````455A556``45A6``4556````````4A5556`````45A556``4A56`````4A5556``4556``45A55556`````455A556``455A56``45A5556````
55A5556````````45555A6``4556``4556````````455556`````455556``4556`````455556``4556``45555556`````45A5556``455556``4555556````