``````````````````````````````````````````````````````````````````````````````````````````````````````````````````````````````````````````````````````
```pz``````````````````````````````````````````````````````````````````````````````````````````````````````````````````````````````````````/``````````
Z````````````````````````````````cc````````````````cc`````cc```````````````````ccZ```````````cc`````````````````````````````cc``````-`````````````````
``````````````````cc````````````c``c``````````````c`````g```c``````````hfg````c``c``````````c``c````````cc`````````````````c``````fg`g````````````````
`````````````````c``c`````G`````f``g````````fG`g`````1222223```fgG```122223`f```````+f````g``fg`G``````c``c```````Gf`````g````12222222223`````````````
`f``g`````f```````Gfgh```123``12222223``12222222223``455A55B2222223``455A5B2223``122223``1222222223````gf``f````122223``1223``4555555A556`````````````
2222222222223``12222223``4A6``4555A556``455A5555556``455555555A5556``4555555A56``455A56``4555555A56``122222223``4555A6``45A6``455A5555556`````````````
5555A55555A56``45555A56``456``4A555556``45555555A56``45555555555556``4A55555556``455556``45A5555556``4555A5556``45A556``4556``455555555A6`````````````
55A5555555556``45555556``456``45555556``45555555556``45555555555556``4555555556``455556``4555555556``4555555A6``455556``4556``45555555556`````````````