```````````````````````````````````````````````````````````````````````````````````````````````````````````````````````````````````````````````
```pz``````````````````````````````````````````````````````````````````````````````````````````````````````````````````````````````````/```````
`````````````````````````````````````````````````cc`````````````cc``````````````````````````````````````cc```````````````cc`````-``````````````
````````````````````cc````cc````````````````````c```Gfg````````c``c``````````````cc````````````````````c``c`````````````c`````g``g`f```````````
```````````````````c``gGf```c`````````````````f```122223```````fg``````````h`f+````c`````````````````fg`G`````````f``g`f```12222222223`````````
`f``g``fh```````g````12223`````fg`G`````````122222C555A6``o``12222223``o``1222223`````f``G``````````12222223``o``12222223``4555555A556`````````
2222222223``o``122222C5A56``12222223``o``o``45555555A556`````45555A56`````455A556``122222223``o``o``455A5556`````455555A6``4555A555556`````````
5555A55556`````45A55555556``4555A556````````455A55555556`````45A55556`````45555A6``4555A5556````````455555A6`````455A5556``4555555A556`````````
55A55555A6`````455555A5556``455555A6````````455555555556`````45555556`````4555556``455555556````````45555556`````45555556``45555555556`````````