`````````````````````````````````````````````````````````````````````````````````````````````````````````````````````````````````
```pS````````z```````````````````````````````````````````````````````````````````````````````````````````````````````````````````/
````````````````````````````cc```````````````````````````````````````````````````````````````````cc``````````````````````````````
```````````````````cc``````c``c```````````````cc``````````````+gh```````cc```````````cc`````````c``c`````````````````````````````
``````````````````c```f`a`g`````f`a``g```````c```g``a``f````122223````````c`````````c``c``````g`afg````````````-`````````````````
`f``g`h`````fg`b`````1222223``122222223```fg````1222222223``4A5556``1223````f``ag```````g````1222222223```hfg````````````````````
22222223``122222223``455A556``45555A556``12223``45555A5556``455A56``4A56``12222222223``1223``455555A556``12222222223`````````````
5555A556``455A55556``4555556``4A5555556``45A56``45A5555556``455556``4556``4555A555556``4A56``45A5555556``45555555556`````````````
55A55556``455555A56``45555A6``455555A56``45556``4555555A56``4555A6``4556``45555555556``4556``4555555556``45555555556`````````````